              SO ./path_to_the_south_texture
WE ./path_to_the_west_texture
                                   EA                 ./path_to_the_eastfff
NO ./path_to_the_north_texture

F 100,30,220
C 255,192,203

11111111111111111
100000000000000011                        
1S001010100000000111
100000000000000011001
10000000000000000111
111111111111111111
