NO ./path_to_the_north_texture
SO ./path_to_the_south_texture
WE ./path_to_the_west_texture
EA ./path_to_the_east_texture

F 220,100,0
C 225,30,0

1111111111111111111
1000000000000000001
1011111111111111101
1000000010000000101
1011111111111111101
100001000000010001
1011111111111111101
1000000000000000001
1111111P1E1P1111111
1000000000000000001
1011111111111111101
100001000P000010001
1011111111111111101
1000000010000000101
1011111111111111101
100000000P000000001
1111111111111111111
